1,1,1,1,1,1,1,1,1,1,1,1,1,1,1,1
1,0,0,1,2,0,2,0,0,0,0,0,0,0,0,1
1,0,0,1,E:0,2,0,2,0,0,0,0,0,0,0,1
1,0,0,1,2,E:0,2,0,2,0,0,0,0,0,0,1
1,0,0,1,E:0,2,E:0,2,0,2,0,0,0,0,0,1
1,0,0,1,2,E:0,2,E:0,2,0,2,0,0,0,0,1
1,0,0,1,E:0,2,E:0,2,E:0,2,0,2,0,0,0,1
1,0,0,1,2,E:0,2,E:0,2,E:0,2,E:0,2,0,2,1
1,0,0,1,1,1,1,1,1,1,1,1,1,1,1,1
1,0,0,E:3,0,0,0,0,0,D,D,D,D,D,D,1
1,0,0,E:3,0,0,0,0,0,D,D,D,D,D,D,1
1,1,1,1,1,1,1,1,1,1,1,1,1,1,1,1
